WWWWWWW
W00WWWW
W00000W
W00W00W
WX000XW
WWWWWWW
2,1
2,2
2,3