WWWWWWW
W000X0W
WXW000W
W00000W
W000WXW
W0X000W
WWWWWWW
3,3
2,3
3,2
3,4
4,3